. . . . . . . . . . . . . . . . . . . . . . . . . . . .
. . . . . . . . . . . . . . . . . . . . . . . . . . . .
w w w w w w w w w w w w w w w w w w w w w w w w w w w w
w c c c c c c c c c c c c w w c c c c c c c c c c c c w
w c w w w w c w w w w w c w w c w w w w w c w w w w c w
w c w . . w c w . . . w c w w c w . . . w c w . . w c w
w c w w w w c w w w w w c w w c w w w w w c w w w w c w
w c c c c c c c c c c c c c c c c c c c c c c c c c c w
w c w w w w c w w c w w w w w w w w c w w c w w w w c w
w c w w w w c w w c w w w w w w w w c w w c w w w w c w
w c c c c c c w w c c c c w w c c c c w w c c c c c c w
w w w w w w c w w w w w c w w c w w w w w c w w w w w w
. . . . . w c w w w w w c w w c w w w w w c w . . . . .
. . . . . w c w w c c c c c c c c c c w w c w . . . . .
. . . . . w c w w c w w w . . w w w c w w c w . . . . .
w w w w w w c w w c w . . . . O . w c w w c w w w w w w
c c c c c c c c c c w . . O . O . w c c c c c c c c c c
w w w w w w c w w c w . . O . O . w c w w c w w w w w w
. . . . . w c w w c w w w w w w w w c w w c w . . . . .
. . . . . w c w w c c c c c c c c c c w w c w . . . . .
. . . . . w c w w c w w w w w w w w c w w c w . . . . .
w w w w w w c w w c w w w w w w w w c w w c w w w w w w
w c c c c c c c c c c c c w w c c c c c c c c c c c c w
w c w w w w c w w w w w c w w c w w w w w c w w w w c w
w c w w w w c w w w w w c w w c w w w w w c w w w w c w
w c c c w w c c c c c c c c c c c c c c c c w w c c c w
w w w c w w c w w c w w w w w w w w c w w c w w c w w w
w w w c w w c w w c w w w w w w w w c w w c w w c w w w
w c c c c c c w w c c c c w w c c c c w w c c c c c c w
w c w w w w w w w w w w c w w c w w w w w w w w w w c w
w c w w w w w w w w w w c w w c w w w w w w w w w w c w
w c c c c c c c c c c c c c c c c c c c c c c c c c c w
w w w w w w w w w w w w w w w w w w w w w w w w w w w w
. . . . . . . . . . . . . . . . . . . . . . . . . . . .
. . . . . . . . . . . . . . . . . . . . . . . . . . . .
. . . . . . . . . . . . . . . . . . . . . . . . . . . .
